13 13 100
2 3 3 0 0 0 0 D 0 2 0 0 1  
3 D 0 0 0 0 0 D 1 0 0 0 0  
3 0 S 0 0 0 3 3 0 1 D D 4  
0 0 0 S D 3 3 0 0 0 D 0 0  
0 0 0 D D D D 3 0 1 D D D  
0 0 0 3 D 0 0 D 0 4 0 0 0  
0 0 3 3 D 0 0 1 0 D 2 0 0  
D D 3 0 3 D 1 D D 1 D D 0  
0 1 0 0 0 0 0 D 0 0 0 2 0  
2 0 1 0 1 4 D 1 0 D 1 0 3  
0 0 D D D 0 2 D 0 1 0 1 3  
0 0 D 0 D 0 0 D 2 0 1 0 0  
1 0 4 0 D 0 0 0 0 3 3 0 0  
