15 15 100
D D 0 1 D 0 0 1 3 5 1 0 0 0 0
D D 0 0 4 0 D 0 3 0 0 0 5 D 3
0 0 2 1 1 0 0 0 0 1 0 1 0 1 0
1 0 1 D 0 2 S 0 0 0 0 D 1 0 0
D 4 1 0 D 0 D 0 D 0 0 0 1 0 1
0 0 0 2 0 4 0 D 0 0 1 1 2 0 0
0 D 0 S D 0 D 0 1 1 1 D 0 0 0
1 0 0 0 0 D 0 0 0 0 D 0 0 0 2
3 3 0 0 D 0 1 0 2 D 1 0 0 0 0
5 0 1 0 0 0 1 0 D 0 0 0 0 D 0
1 0 0 0 0 1 1 D 1 0 D 0 0 D 0
0 0 1 D 0 1 D 0 0 0 0 0 0 D 0
0 5 0 1 1 2 0 0 0 0 0 0 D 0 0
0 D 1 0 0 0 0 0 0 D D D 0 0 0
0 3 0 0 1 0 0 2 0 0 0 0 0 0 D
