15 15 100
2 3 3 D 0 0 D 0 0 0 D 1 0 D D
3 D 0 0 0 0 0 0 0 0 0 0 0 1 0
3 0 2 0 D 0 1 D 0 0 0 0 0 0 0
D 0 0 0 D 0 0 0 0 0 D 0 1 1 2
0 0 D D D 0 0 0 0 0 0 1 0 0 0
0 0 0 0 0 0 0 D 0 0 0 0 D 3 4
D 0 1 0 0 0 0 0 0 1 0 1 2 2 0
0 0 D 0 0 D 0 0 0 0 D 0 0 0 D
0 0 0 0 0 0 0 0 D 0 0 1 1 0 0
0 0 0 0 0 0 1 0 0 D 0 0 2 D 2
D 0 0 D 0 0 0 D 0 0 0 0 1 3 4
1 0 0 0 1 0 1 0 1 0 0 D S 0 1
0 0 0 1 0 D 2 0 1 2 1 S 0 D 5
D 1 0 1 0 3 2 0 0 D 3 0 D 0 1
D 0 0 2 0 4 0 D 0 2 4 1 5 1 0
