15 15 100
D 0 0 0 0 0 D D D D 0 0 0 0 0
0 3 0 D 1 0 D 1 0 0 1 3 1 D 1
0 0 D 1 0 0 D 0 2 2 1 1 5 1 1
0 D 1 2 D 2 D 1 S D 0 0 0 3 0
0 1 0 D 2 0 1 1 D 0 0 1 0 D D
0 0 0 2 0 2 0 1 D 0 1 0 0 0 0
D D D D 1 0 D D D D 0 0 0 0 1
D 1 0 1 1 1 D 0 1 D 0 D D D 1
D 0 2 S D D D 1 0 0 0 0 3 0 0
D 0 2 D 0 0 D D 0 0 0 D D 2 0
0 1 1 0 0 1 0 0 0 0 0 0 0 0 1
0 3 1 0 1 0 0 D 0 D 0 D 0 0 0
0 1 5 0 0 0 0 D 3 D 0 0 2 1 0
0 D 1 3 D 0 0 D 0 2 0 0 1 D 0
0 1 1 0 D 0 1 1 0 0 1 0 0 0 3
