15 15 100
D D 0 0 1 0 0 0 0 0 D 1 2 0 0
D D S 0 0 0 0 0 0 0 D 1 0 0 D
0 S 0 D 0 D 0 2 D 5 D 0 0 0 0
0 0 D 2 2 0 1 0 2 0 D 1 0 1 0
1 0 0 2 D 0 0 2 D 1 0 0 1 D 0
0 0 D 0 0 D 1 1 1 1 D 0 0 D 2
0 0 0 1 0 1 D 0 1 D 1 0 0 0 1
0 0 2 0 2 1 0 0 0 0 0 0 0 2 1
0 0 D 2 D 1 1 0 2 3 D 1 D D D
0 0 5 0 1 1 D 0 3 D 3 0 0 0 1
D D D D 0 D 1 0 D 3 2 0 0 2 D
1 1 0 1 0 0 0 0 1 0 0 0 D 0 D
2 0 0 0 1 0 0 0 D 0 0 D D 0 D
0 0 0 1 D D 0 2 D 0 2 0 0 4 D
0 D 0 0 0 2 1 1 D 1 D D D D D
