15 15 100
0 0 1 3 2 D 0 0 1 0 0 D 0 1 2
0 2 0 0 1 S 2 0 0 1 1 D 1 3 1
1 0 D 0 0 0 0 0 1 0 0 D 1 0 0
3 0 0 0 0 1 2 1 0 0 D 0 0 D 1
2 1 0 0 D D 0 0 D 0 1 1 1 2 D
D S 0 1 D D 0 0 D 0 4 D 0 0 1
0 2 0 2 0 0 D 0 D 0 0 1 D 0 0
0 0 0 1 0 0 0 0 D 0 0 0 1 0 0
1 0 1 0 D D D D D 1 0 0 1 1 0
0 1 0 0 0 0 0 0 1 0 0 1 0 0 D
0 1 0 D 1 4 0 0 0 0 D 1 0 3 0
D D D 0 1 D 1 0 0 1 1 0 0 0 0
0 1 1 0 1 0 D 1 1 0 0 0 D 1 1
1 3 0 D 2 0 0 0 1 0 3 0 1 0 D
2 1 0 1 D 1 0 0 0 D 0 0 1 D D
