15 15 100
0 3 2 2 D 1 0 0 0 0 0 0 3 D D
3 D 3 S 3 0 0 0 1 0 0 0 1 D D
2 3 D 3 3 0 1 0 0 3 0 0 0 1 0
2 S 3 D D 0 D D D D 0 D 0 0 0
D 3 3 D 0 1 0 0 0 0 0 D 1 1 0
1 0 0 0 1 0 0 0 0 1 0 0 0 0 3
0 0 1 D 0 0 D D 1 0 0 1 0 0 1
0 0 0 D 0 0 D 0 0 0 0 1 1 0 D
0 1 0 D 0 0 1 0 0 0 D D 0 1 D
0 0 3 D 0 1 0 0 0 0 0 3 0 0 D
0 0 0 0 0 0 0 0 D 0 D D 3 0 D
0 0 0 D D 0 1 1 D 3 D D 0 0 D
3 1 0 0 1 0 0 1 0 0 3 0 D 0 0
D D 1 0 1 0 0 0 1 0 0 0 0 D 1
D D 0 0 0 3 1 D D D D D 0 1 0
