11 11 50
5 1 0 0 0 0 0 D 1 5 1    
1 2 D 1 0 1 1 0 0 0 1    
0 D 5 0 0 0 0 5 D 2 0    
0 1 0 D 1 S 0 0 0 0 1    
0 0 0 1 D 0 1 D 1 0 D    
0 1 0 S 0 0 0 0 1 1 0    
0 1 0 0 1 0 0 3 1 2 3    
D 0 5 0 D 0 3 D 1 0 4    
1 0 D 0 1 1 1 1 D 1 0    
5 0 2 0 0 1 2 0 1 D 4    
1 1 0 1 D 0 3 4 0 4 D    
